0100010100010101010100010000000
0111010111010101010101110111111
0000000000000001010001010100010
1111011111110111011101010101110
0000010001000000000000000000000
0101111101010101110101011111111
0100010100010100010101000000010
0111110101110101011101010101110
0000010001000101010001010100000
1111110101110101110101111101110
0000010101000101000100000100010
1101011101110111110101011101111
0101000000010100000101000100000
0111011101110111010101111101111
0000010001000101010100000100000
0101110101110101110101011101010
0101000101010100000101010001010
0101110101011101110101110101111
0101000101000001000100010100000
0111110111110101111101011101011
0000010100000101000001010001000
0101110101010101110111010101011
0101000101010101000101010101000
0111011111010101010101111111110
0100000001010101010000010000000
0101011111110111011101010101010
0101010000010001000101010101010
1111011111010111011101010111110
0000000100010001010001010000010
0111110111010101011101110111010
0100000100000101000101000001010
