0100000000010100010000010000000
0111111111010111011111010101111
0100000000000001010000000100000
0101111111111101011111011101011
0001000101000000000000000101000
1101011101010101010111011111010
0101000000010101010100010000010
0111011101111101110101010111011
0000010001000001000101010100000
1111011111011101111101111101110
0000010000010001000000010001000
0101111111010101110111011101110
0101010100010101000100010000010
1101010111111101011101011111010
0001000000000001010001000101010
0111110111010101110101011101110
0100000100010101000101010000000
0111110111011101010101110111010
0101000001010001010100010100010
0101010101110111110101011101110
0100010100010100000101010000010
1101010101111111110111110101110
0001010101000000000000010101010
0101110101110111011101111101011
0101000101000100010000010100000
0101110101110101111101110111111
0101010101000101010100000000000
0111011111010101010101011101111
0100000000010101000001010000000
1111110101111111010111111101011
0000000100010000010100000001000
